W W W W W W W W W W W E E E W W W W W W W W W E
W P S S S W S S S S W W W W W S S S W S S S W W
W W W S S S S S W W S W W W S S S S S S S S S W
E W S S S S S S S W S S W S S W W S S S W S W W
W W S S S W W W S S S W W S S S W W S W W S W E
W S S W S S W S S S W W S S S S S W W W S S W W
W W S W W S S S S W W S S S W S S S B B S S S W
E W S S W W S S W W S S S W S W S S S W W S W W
W W S S S W W S S W W S S S S S S S W W S S W E
W S S S W W S S S S W W S S S S S W W S S S W W
W W S W W S S S S S S W W S S S W W S S S S S W
E W S W S S S W W S S S W W S W W S S S W S W W
W W S S S S W S S W S S S S S S S S S W S S W E
W S S W S S S S S S W S S S S S S S W 2 S S W W
W W S W W S S S S W S S S W W W S S S W S S S W
E W S S W W S S W S S S W W 1 W W S S S W S W W
W W S W W S S S S S S W W S S S S S S S S W W E
W S S W S S S W S S W W S S S S S W S S S S W W
W W S S S S W W W S S S S S S S W W W S S S S W
E W W W W W W E W W W W W W W W W E W W W W W W