W W W W W W W W W W W W W W W W W W W W W W W W
W P S S S S S S S S S S S S S S S S W S S S S W
W S W W W S I S W W W S S W W W S S S S S W W W
W S S W S S S S S W S S W W S W W S S S W W S W
W S S S S W W W S S S W W S S S W W S W W S S W
W S W W S B W S S B W W S S S S S W W W S S S W
W S S W W S S S S W W S S S W S S S B B S S W W
W S S S W W S S W W S S S W S W S S S W W S S W
W W I S S W W B S W W S S B S S S S W W S S S W
W S S S W W S S S S W W S S S S S W W S S S W W
W S S W W S S S S S S W W S S S W W S S S W I W
W S W W S S S W W S S S W W S W W S S S W S S W
W S S S S S W S S W S S S S S S S S S W S S S W
W S W W S S S S S S W S S B S S S S W 2 S S W W
W S S W W S S S S W S S S W W W S S S W S S S W
W S S S W W S S W S S S W W 1 W W S S S W S S W
W S S W W S S W S S B W W S S S W W B S S W S W
W S W W I S W S S S W W S S S S S W W S B S S W
W W W S S S S S B W W S S S S S S S S S S S S W
W W W W W W W W W W W W W W W W W W W W W W W W