W W W W W W W W W W W W W W W W W W W W W W W W
W P S S S S S S S S S S S S S S S S S S S S I W
W W W W W W W W W W W W W W W W W W W W W W S W
W S S S S S S S S S S S S S S S S S S S S W S W
W S W W W W W W W W W W W W W W W W W W S W S W
W S W S S S S S S S S S S S S S S S S W S W S W
W S W S W W W W W W W W W W W W W W E W S W S W
W S W S W E E E W W E E E W E W E E E W S W S W
W S W S W W E E E W W E E E E E E E W W S W S W
W S W S W E E E E E W W E E E E E W W W S W S W
W S W S W E E E E E E W W E E E W W 2 W S W S W
W S W S W E E W W E E E W W E W W E E W S W S W
W S W S W E E E W W E E E E E E E E E W S W S W
W S W S W E E E 1 W W E E E E E E E W W S W S W
W S W S W E E E W W E E E E W E E E E W S W S W
W S W S W W W W W W W W W W W W W W W W S W S W
W S W S S S S S S S S S S S S S S S S S S W S W
W S W W W W W W W W W W W W W W W W W W W W S W
W B S S S S S S S S S S S S S S S S S S S S S W
W W W W W W W W W W W W W W W W W W W W W W W W