W W W W W W W W W W W W W W W W W W W W W W W W
W P S S S S S S S S S S S S S S S S S S S S S W
W W W W S W W W W W B W W W W W W W B W W W S W
W S S S S S S S S S S S S S S S S S S S S W S W
W S W B W W W W W W W W W W S W W W W W S B S W
W S W S S S S S S S S S S S S S B S S W S W S W
W S B S W W S W W W W W W W W W W W B W S W S W
W S W S W S I S W W S S S W I W S S S W S W S W
W S W S W W S S S W W S S S S S S S W W S W S W
W S W S W S S I S B W W S S S S S W W W S W S W
W S B S W S S S S S S W W S S S W W 2 W S W S W
W S W S B S S W W S S S W W I W W S B W S S S W
W S B S W S S S W W S S S S S S S S S W S W B W
W S W S W S S B 1 W W S S S S S S S W W S W S W
W S W S W S S S W W S S I S W S I S S W S W S W
W S W S W W W W W W W B W W W W W W B W S I S W
W S W S S S S S S S S S S S S S S S S S S W S W
W S W W W W W W I W W W W I W W W W W W W W S W
W S S S S S S S S S S S S S S S S S S S S S S W
W W W W W W W W W W W W W W W W W W W W W W W W